Flag=Flag-CNF
Language=Chinese
English=English
Chinese=中文
ChineseF=繁体
UIDay=天
UIHour=时
UIMinute=分
UISecond=秒
DayBefore=天之前
HourBefore=小时之前
MinutesBefore=分钟之前
SecondBefore=秒之前
Loading=死命加载中...
Version=版本
EnterGame=点击开始游戏
Click4Select=点击切换
LastServer=上次登陆
Okay=确定
Cancel=取消
Remove=移除
Detail=详情
Upgrade=升级
SpeedUp=加速
Build=建造
Research=研究
Union=联盟
Pet=宠物
Collect=收集
Treasure=宝物
Mail=邮件
Announcement=公告
Activity=活动
Reward=奖励
Level=等级
LevelWithNum=%d级
Yes=[00ff00]是[-]
No=[ff0000]否[-]
CanPlaceOnGround=可以修建在地上
CanPlaceOnOcean=可以修建在海上
HP=生命值
Worker=工人
Tile=地块
NextLevOpen=下级解锁
None=无
Precondition=前置条件
Immediately=立即
Renew=修复
Extend=扩建
Update=立即更新
UpdateLater=稍后再试
Setting=设置
Tip=提示
MsgExitGame=[B75605]确定要退出游戏？[-]
Headquarters=主基地
HeadquartersInfor=升级主基地可以解锁更多的建筑.\n战斗中如果主基地被摧毁攻击方至少能得一星，因此请保护好您的主基地
TechnologicalCentre=科技研究中心
TechnologicalCentreInfor=研究高等级战舰
Arsenal=造船厂
ArsenalInfor=升级后可以建造更高级的舰船
FoodFactory=粮食加工厂
FoodFactoryInfor=粮食加工厂可以产出粮食，等级越高产量超大，最多可以产出8小时产量。
FoodStorage=粮仓
FoodStorageInfor=将粮食加工厂产出的粮食安全储藏
OilWell=油井
OilWellInfor=油井可以生产石油，等级越高产量超大，最多可以产出8小时产量。
GoldMine=金矿
GoldMineInfor=金矿可以生产金币，等级越高产量超大，最多可以产出8小时产量。
GoldStorage=金库
GoldStorageInfor=将采集到的金矿安全储藏
OilStorage=油库
OilStorageInfor=将采集到的石油安全储藏
Alliance=联盟
AllianceInfor=加入联盟可以增加防御力和舰队的攻击力
Colonial=殖民局
Dockyard=船坞
Cannon=蜂鸟式加农炮
ArrowTower=鹰眼式激光塔
HeavyGun=鲨鱼式电磁炮
Rocket=火鸟式火箭炮
Mortar=烈焰式火箭炮
Thunderbolt=死亡电塔
DestroyerRocket=末日之门
Landmine=地雷
AirBomb=防空气球
Mine=水雷
FrozenMine=冰冻地雷
IceStorm=冰风暴陷阱
Monster=克拉肯海怪
Swirl=漩涡发生器
CallHeroDoor=末日召唤
Summon=召唤
Tree=树
Pine=松树
Flag1=雄狮军旗
Flag2=海怪军旗
Flag3=十字军旗
Flag4=海盗旗
Flag5=卖萌海盗旗
Sculpture=飓风龙神
Wood=树桩
Bush=灌木
Basic=基础
Resource=资源
Defense=防御
Trap=陷阱
Decoration=装饰
CannotProcTile=该地块不可操作
CannotPlaceTile=不能扩建地块！
MsgOffline=网络抽疯了，让我抽它一巴掌！
MsgCheckAppUpgradeFail=检测版本失败！
MsgHadNewVerApp=亲，发现新版本，更新后体验更佳哦！
MsgWelcome=[462306]亲爱的玩家，欢迎来到《海岛大作战2》，建立属于自己的海岛，征服七海，成为海上霸主！\nQQ官方群：[-][008000]927410247[-]
MsgServerIsMaintain=服务器正在维护中，请耐心等待，详细查看公告，谢谢您的支持！
MsgOutofConnect=网络不通畅，确认是否正常联网！
UserIllegal=账号只能包含英文、数字！
PasswordIllegal=密码只能包含英文、数字！
UserIsEmpty=账号密码不能为空!
UserPasswordIsError=账号或密码错误！
PasswordConfirmError=密码确认不一致！
EmailIllegal=请输入正确的电子邮箱！
MsgUseDiamSpeedUp=[B75605]确定使用[-][ff0000]%d钻石[-][B75605]立即完成升级？[-]
MsgCollectResIsFull=仓库空间不足，不可以收集！
MsgStoreIsFull=仓库已满，升级可以提升存储量！
MsgPleaseInputNumber=数量为0！
Barbarian=陆战队员
WhiteDolphinInfor=擅长登陆作战，骁勇善战
DolphinsGrade=海盗
Archer=狩猎级驱逐舰
YellowFlyingfishInfor=轻型战舰，可以攻击海陆空单位
FlyingFishGrade=炮艇
Goblin=贼鸥级飞艇
BlueWhaleInfor=优先攻击资源建筑
WhaleGrade=劫掠快艇
Giant=巨人级护卫舰
GreenSeaUrchinsInfor=优先攻击防御设施
SeaUrchinsGrade=重装劫掠艇
WallBreaker=毁灭者自爆炸弹
BloodSharkInfor=无差别自杀式袭击
BloodSharkGrade=自爆船
Balloon=地狱飞艇
BlackKillerWhaleInfor=速度缓慢的空中单位，优先攻击防御
KillerWhaleGrade=地狱飞艇
KingFlagShip=无畏级战列舰
KingFlagShipInfor=终极舰船，可以远程攻击陆地建筑
LandCraft=破浪级登陆艇
LandCraftInfor=最多可以配置6名陆战队员，本身无攻击力
GhostPirates=幽灵海盗号
GhostPiratesInfor=特效强化型：速度高，攻击超高，防御中，射程中
LandDragon=大地暴龙
LandDragonDesc=没错，这是条巨龙，城墙在它面前就不值一提。可惜由于以前在战斗中受过伤，使得它攻击力锐减,就当它是最好的肉盾吧。
ElementsNaga=元素纳迦
ElementsNagaDesc=元素族群的遗弃之民，拥有强大的远程魔法力量，身体的孱弱却是致命弱点。记住“在魔法的世界里，神马都是浮云！”
Machinery=X-3
MachineryDesc=地精科技震撼人心！！！时间就是金钱，我的朋友！X-3型5金一个，能飞天遁地，无所不能…
Spirit=精灵
SpiritDesc=可爱的小精灵拥有强大的魔法，可以帮助友军快速回血
FireSpirit=火精灵
FireSpiritDesc=来自海底火山的火精灵，拥有强大无比的火弹术，能摧毁方圆几百公里的一切。厉害吧，怕了吧.
Jelly=霜火水母
JellyDesc=一种变异的会飞的水母
Error_0=脑子居然短路了，好像哪里出错了？
BGM=音乐
SoundEffect=音效
InputUser=账号(请输入长度3-10位的英数)
InputPassword=密码(请输入长度3-10位的英数)
PasswordConfirm=密码确认
RegistWithLine=[u]注册[/u]
Regist=注册
Login=登录
InputEmail=邮箱(选填，用于密码找回)
SelectServer=选择服务器
StateCrowded=爆满
StateMaintain=维护
StateNomal=顺畅
Food=粮食
Gold=金币
Oil=石油
Diam=钻石
AttackDistance=攻击半径
AttackSpeed=攻击速度
AttackVal=攻击力
MulAttack=群伤
BuildShip=造船
ShipSpace=船坞空间
BuildTime=建筑时间
Cost=消耗
DockyardBusy=建造厂很繁忙!
Number=数量
Time=时间
Enter=进入
Attack=攻击
MoveCity=搬迁